CB 0 11 12
RB 1 11 15
RB 4 7 6
RB 10 4 6
CB 15 10 6
RB 20 4 6
RB 24 7 2
RB 22 11 16
RS 26 8 3
CB 29 8 9
RB 30 8 3
RB 30 4 2
RS 30 7 1
RB 34 6 3
RB 34 2 3
RS 35 3 2
CB 37 10 9
RS 38 6 25
RB 42 2 1
RB 45 4 1
RB 48 6 2
RB 52 4 3
RB 56 2 7
ED 61 1
ED 3 10
